Date,Description,Debit,Credit,Balance
2024-12-18,Gift,100.00,0.00,100.00
2024-12-18,Job,180.00,0.00,280.00
2024-12-18,Gift,180.00,0.00,460.00
2024-12-18,Job,200.00,0.00,660.00
2024-12-18,Gathering,0.00,100.00,560.00
2024-12-20,Bonus,160.00,0.00,720.00
2024-12-20,Restaurant,0.00,50.00,670.00
